NO ./textures/north.xpm
SO ./textures/south.xpm
WE ./textures/west.xpm
EA ./textures/east.xpm

F 80, 20, 20
C 200, 150, 100

F 100, 149, 237
C 25, 25, 112

11111111
100S0001
10000000
11111111
