NO ./textures/north.xpm
SO ./textures/south.xpm
WE ./textures/west.xpm
EA ./textures/east.xpm

F 80, 20, 20
C 200, 150, 100

111111111111111
100000000000001
101111011111101
101000010000101
101011111110101
101010000010101
101010111010101
100010101010001
111010101011111
100010000010001
101111111111101
101000000000101
101011111110101
100000000000001
111111111111111
