NO ./textures/north.xpm
SO ./textures/south.xpm
WE ./textures/west.xpm
EA ./textures/east.xpm

F 100, 149, 237
C 25, 25, 112

1111111111
1N00000001
1000110001
1000000001
1000110001
1000000001
1111111111
