NO ./textures/north.xpm
SO ./textures/south.xpm
WE ./textures/west.xpm
EA ./textures/east.xpm

F 50, 50, 50
C 135, 206, 235

1111111111111
1000001000W01
1011101011101
1000100010001
1111111111111
